# Special
UNI = "countries/UnitedNations.txt"
PLH = "countries/Placeholder.txt"

# Western Europe
POB = "countries/Portugal-Brazil.txt"
IBU = "countries/IberianUnion.txt"
SPC = "countries/Spain.txt"
SPR = "countries/Spain.txt"
SPF = "countries/Spain.txt"
FAI = "countries/FaroeIslands.txt"
GBC = "countries/GreatBritain.txt"
UKI = "countries/GreatBritain.txt"
UKC = "countries/GreatBritain.txt"
UKU = "countries/GreatBritain.txt"
UKF = "countries/GreatBritain.txt"
CMN = "countries/CommonwealthofNations.txt"
JER = "countries/Jersey.txt"
NIR = "countries/NorthernIreland.txt"
EIR = "countries/Ireland.txt"
DRP = "countries/Netherlands.txt"
BRP = "countries/Belgium.txt"
BEC = "countries/Belgium.txt"
BEF = "countries/Belgium.txt"
ABL = "countries/Belgium.txt"
WLL = "countries/Wallonia.txt"
ASL = "countries/Alsace-Lorraine.txt"
KOF = "countries/France.txt"
NPF = "countries/France.txt"
FRC = "countries/ModernFrance.txt"
FRF = "countries/ModernFrance.txt"

# Central Europe
SNO = "countries/Norway.txt"
DNO = "countries/Norway.txt"#
SWD = "countries/Sweden.txt"
SWL = "countries/Sweden.txt"
SWN = "countries/Sweden-Norway.txt"
SCN = "countries/Scania.txt"
ALD = "countries/Aland.txt"
FIL = "countries/Finland.txt"
NGC = "countries/NorthGermany.txt"
SGC = "countries/SouthGermany.txt"
DEU = "countries/WestGermany.txt"
DDR = "countries/EastGermany.txt"
NZG = "countries/Germany.txt"
PRE = "countries/Prussia.txt"
RHI = "countries/Rhineland.txt"
SLA = "countries/Saarland.txt"
GDH = "countries/Hesse-Darmstadt.txt"
BAW = "countries/Baden-Wurttemberg.txt"
WMA = "countries/Weimar.txt"
MIG = "countries/Meiningen.txt"
ATB = "countries/Altenburg.txt"
SIG = "countries/Sigmaringen.txt"
LTS = "countries/Liechtenstein.txt"
MST = "countries/Mecklenburg-Strelitz.txt"
WLD = "countries/Waldeck.txt"
KGO = "countries/Kaliningrad.txt"
CPO = "countries/Poland.txt"
POZ = "countries/Poznan.txt"
SDT = "countries/Sudetenland.txt"
WUA = "countries/WestUkraine.txt"
BKV = "countries/Bukovina.txt"
AUE = "countries/Austria.txt"
HA2 = "countries/Austria.txt"
HA3 = "countries/Austria.txt"
GCF = "countries/GermanConfederation.txt"
BNR = "countries/Bern.txt"
FBG = "countries/Fribourg.txt"
SYZ = "countries/Schwyz.txt"
TIC = "countries/Ticino.txt"
VAI = "countries/Valais.txt"
VUD = "countries/Vaud.txt"
SDB = "countries/Sonderbund.txt"#
RMR = "countries/RomanRepublic.txt"
ITS = "countries/Italy.txt"
ITP = "countries/Italy.txt"
ITU = "countries/Italy.txt"
RSI = "countries/Italy.txt"
BMT = "countries/BritishMalta.txt"
EUC = "countries/Europeanunion.txt"
EUF = "countries/Europeanunion.txt"

# Eastern Europe
BLP = "countries/Baltics.txt"
BDR = "countries/Belarus.txt"
RUE = "countries/Russia.txt"
RSF = "countries/Russia.txt"
ROS = "countries/Russia.txt"
MKH = "countries/Makhnovia.txt"#
SBR = "countries/Siberia.txt"
YKU = "countries/Yakutia.txt"
FEA = "countries/FarEasternRepublic.txt"
CEH = "countries/Chechnya.txt"
DAG = "countries/Dagestan.txt"
CSE = "countries/Crimea-Sevastopol.txt"
DTK	= "countries/Donetsk.txt"
LUH	= "countries/Luhansk.txt"
NRS = "countries/Novorossiya.txt"
VLG = "countries/Volga.txt"
DOH = "countries/DonHost.txt"
KUH = "countries/KubanHost.txt"
CIS = "countries/CIS.txt"
SRY = "countries/Yugoslavia.txt"
VOJ = "countries/Vojvodina.txt"
SRP = "countries/Srpska.txt"
UPP = "countries/UnitedPrincipalities.txt"
SEB = "countries/Siebenburgen.txt"
SZE = "countries/Szekely.txt"
SHQ = "countries/Albania.txt"
HEL = "countries/Greece.txt"
HEF = "countries/Greece.txt"
POS = "countries/Samos.txt"
ION = "countries/IonianIslands.txt"
BCY = "countries/BritishCyprus.txt"
GCY = "countries/GreekCyprus.txt"
TCY = "countries/TurkishCyprus.txt"
ARE = "countries/Armenia.txt"
AKH = "countries/Artsakh.txt"
NKC = "countries/Nakhchivan.txt"
TCC = "countries/Transcaucasia.txt"
APG = "countries/SouthAzerbaijan.txt"

# North America
CUL = "countries/Columbia.txt"
HBC = "countries/HudsonBayCompany.txt"
UCA = "countries/UpperCanada.txt"
LCA = "countries/LowerCanada.txt"
NBR = "countries/NewBrunswick.txt"
PEI = "countries/PrinceEdwardIsland.txt"
NSC = "countries/NovaScotia.txt"
MRU = "countries/MaritimeUnion.txt"#

US2 = "countries/USA.txt"
U14 = "countries/USA.txt"
U15 = "countries/USA.txt"
U16 = "countries/USA.txt"
U17 = "countries/USA.txt"
U18 = "countries/USA.txt"
U19 = "countries/USA.txt"
U20 = "countries/USA.txt"
U21 = "countries/USA.txt"
U22 = "countries/USA.txt"
U23 = "countries/USA.txt"
U24 = "countries/USA.txt"
U25 = "countries/USA.txt"
U26 = "countries/USA.txt"
U27 = "countries/USA.txt"
U28 = "countries/USA.txt"
U29 = "countries/USA.txt"
U30 = "countries/USA.txt"
U31 = "countries/USA.txt"
U32 = "countries/USA.txt"
U33 = "countries/USA.txt"
U34 = "countries/USA.txt"
U35 = "countries/USA.txt"
U36 = "countries/USA.txt"
U37 = "countries/USA.txt"
U38 = "countries/USA.txt"
U39 = "countries/USA.txt"
U40 = "countries/USA.txt"
U41 = "countries/USA.txt"
U42 = "countries/USA.txt"
U43 = "countries/USA.txt"
U44 = "countries/USA.txt"
U45 = "countries/USA.txt"
U46 = "countries/USA.txt"
U47 = "countries/USA.txt"
U48 = "countries/USA.txt"
U49 = "countries/USA.txt"
U50 = "countries/USA.txt"
U51 = "countries/USA.txt"
FSA = "countries/FreeStates.txt"#
NAF = "countries/NewAfrica.txt"
PCS = "countries/PacificStates.txt"#
DSR = "countries/Deseret.txt"
NEN = "countries/NewEngland.txt"
OKL = "countries/Oklahoma.txt"
CRW = "countries/Crow.txt"
NEZ = "countries/NezPerce.txt"
UTE = "countries/Ute.txt"

PUR = "countries/PuertoRico.txt"
MXE = "countries/Mexico.txt"
RGR = "countries/TheRioGrande.txt"
ZPA = "countries/Zapatista.txt"
MKI = "countries/Miskito.txt"

# South America
GCO = "countries/GranColombia.txt"
GPA = "countries/Grao-Para.txt"
BR2 = "countries/Brazil.txt"
NPE = "countries/NorthPeru.txt"#
SPE = "countries/SouthPeru.txt"
PBO = "countries/Peru-Bolivia.txt"

# North Africa
RIF = "countries/Rif.txt"
FPM = "countries/Morocco.txt"
FPT = "countries/Tunisia.txt"
TU2 = "countries/Tunisia.txt"
KHE = "countries/Egypt.txt"
MHI = "countries/Mahdists.txt"

# Ethiopia
TIG = "countries/Tigray.txt"
BGM = "countries/Begemder.txt"
WLO = "countries/Wello.txt"
GJM = "countries/Gojjam.txt"
WLG = "countries/Welega.txt"
SDM = "countries/Sidamo.txt"

# Africa
PNT = "countries/Puntland.txt"
AOF = "countries/FrenchWestAfrica.txt"
AEF = "countries/FrenchEquatorialAfrica.txt"
WTO = "countries/WesternTogoland.txt"
BIA = "countries/Biafra.txt"
CFS = "countries/CongoFreeState.txt"
KTA = "countries/Katanga.txt"
EAF = "countries/EastAfricanFederation.txt"
SRD = "countries/SouthernRhodesia.txt"#

# South Africa
CPE = "countries/CapeRepublic.txt"
GQL = "countries/Griqualand.txt"
TVA = "countries/Transvaal.txt"
CEC = "countries/CapeColony.txt"
NAC = "countries/NatalColony.txt"
ORC = "countries/OrangeRiverColony.txt"
TVC = "countries/TransvaalColony.txt"
SAF = "countries/UnionofSouthAfrica.txt"

# Asia
RJA = "countries/Rojava.txt"
KRR = "countries/KurdistanRegion.txt"
MHB = "countries/Mahabad.txt"
IRP = "countries/Iraq.txt"
IRB = "countries/Iraq.txt"
MPL = "countries/MandatoryPalestine.txt"
ADP = "countries/Aden.txt"
YER = "countries/Yemen.txt"
TRU = "countries/TrucialStates.txt"

IR2 = "countries/Iran.txt"
BZH = "countries/BukeyZhuz.txt"
UZH = "countries/UlyZhuz.txt"
OZH = "countries/OrtaZhuz.txt"
IZH = "countries/KishiZhuz.txt"
KKP = "countries/Karakalpakstan.txt"
DRI = "countries/Durrani.txt"
KAB = "countries/Kabul.txt"
HRA = "countries/Herat.txt"
QAN = "countries/Qandahar.txt"
TLI = "countries/Afghanistan.txt"

BBU = "countries/BritishBurma.txt"
KCH = "countries/Kachin.txt"
RKH = "countries/Rakhine.txt"
KAE = "countries/Karen.txt"
THL = "countries/Thailand.txt"

BML = "countries/BritishMalaya.txt"
PIN = "countries/Penang.txt"
TGG = "countries/Terengganu.txt"
SGR = "countries/Selangor.txt"
SBH = "countries/Sabah.txt"
EIN = "countries/EastIndies.txt"
SKT = "countries/Surakarta.txt"
YOG = "countries/Yogyakarta.txt"
WNG = "countries/WestNewGuinea.txt"

PHW = "countries/Philippines.txt"
KOE = "countries/KoreanEmpire.txt"
SJP = "countries/Japan.txt"
EJP = "countries/Japan.txt"
EZO = "countries/Ezo.txt"
NBS = "countries/Nabeshima.txt"
YMU = "countries/Yamauchi.txt"
ASN = "countries/Asano.txt"
TOD = "countries/Todo.txt"
SKI = "countries/Sakai.txt"

# China
EOC = "countries/ImperialChina.txt"
ROC = "countries/NationalistChina.txt"
REC = "countries/ReorganizedChina.txt"
PRC = "countries/CommunistChina.txt"

TPG = "countries/Taiping.txt"
KUO = "countries/Kuomintang.txt"
CCP = "countries/ChineseCommunistParty.txt"
AUI = "countries/Anhui.txt"
FEN = "countries/Fengtian.txt"
FJN = "countries/Fujian.txt"
GDG = "countries/Guangdong.txt"
GXI = "countries/Guangxi.txt"
HBE = "countries/Hubei.txt"
HNN = "countries/Hunan.txt"
KAI = "countries/Kashgaria.txt"
MCL = "countries/MaClique.txt"
SCC = "countries/Sichuan.txt"
SHX = "countries/Shanxi.txt"
XJG = "countries/Xinjiang.txt"
YNA = "countries/Yunnan.txt"
ZHI = "countries/Zhili.txt"
KML = "countries/KumulKhanate.txt"
PMC = "countries/PortugueseMacau.txt"
BHK = "countries/BritishHongKong.txt"
MCU = "countries/Macau.txt"
HGK = "countries/HongKong.txt"
QDA = "countries/Qingdao.txt"
TWA = "countries/Taiwan.txt"

# India
BBP = "countries/BombayPresidency.txt"
BGP = "countries/BengalPresidency.txt"
MDP = "countries/MadrasPresidency.txt"
RHJ = "countries/ColonialRaj.txt"
BRJ = "countries/BritishRaj.txt"

HYD = "countries/Hyderabad.txt"
NGL = "countries/Nagaland.txt"
BKH = "countries/Kalat.txt"
KHR = "countries/Kharan.txt"
LAS = "countries/LasBela.txt"
MKR = "countries/Makran.txt"
KHP = "countries/Khairpur.txt"
BHW = "countries/Bahawalpur.txt"
IDO = "countries/Indore.txt"
BHP = "countries/Bhopal.txt"

# Oceania
ABO = "countries/AboriginalAustralia.txt"#
NSW = "countries/NewSouthWales.txt"
QLD = "countries/Queensland.txt"
SSA = "countries/SouthAustralia.txt"
TAS = "countries/Tasmania.txt"
VIC = "countries/Victoria.txt"
WAU = "countries/WesternAustralia.txt"
NTE = "countries/NorthernTerritory.txt"
FFC = "countries/ChristmasIsland.txt"
CCI = "countries/CocosIslands.txt"
UNZ = "countries/UnitedTribes.txt"
GUH = "countries/Guam.txt"
EIS = "countries/RapaNui.txt"

# Random Island/OPM Nations
BMU = "countries/Bermuda.txt"
CUW = "countries/Curacao.txt"
CYM = "countries/Caymans.txt"
FLK = "countries/Falklands.txt"
GIB = "countries/Gibraltar.txt"
MSR = "countries/Montserrat.txt"
NCL = "countries/NewCaledonia.txt"
SHE = "countries/SaintHelena.txt"
TCA = "countries/Turks-Caicos.txt"
VGI = "countries/VirginIslands.txt"
IOT = "countries/IndianOceanTerritory.txt"
GLP = "countries/Guadeloupe.txt"
MTQ = "countries/Martinique.txt"
GUF = "countries/Guyane.txt"
REU = "countries/Reunion.txt"
ABC = "countries/NetherlandsAntilles.txt"
SXM = "countries/SintMaarten.txt"

# Misc. British Dominions/Subjects
CA1 = "countries/Canada.txt"
CA2 = "countries/Canada.txt"
AU1 = "countries/Australia.txt"
AU2 = "countries/Australia.txt"
NZ1 = "countries/Zealandia.txt"
NZ2 = "countries/Zealandia.txt"
IN1 = "countries/India.txt"
IN2 = "countries/India.txt"

